111111111111111111111111111
111110111C00000000000000111
100P10011110000000C00000001
101110000001000C001000000E1
10000000000000111000C011111
1110C0001111100000001111001
111111111111111111111111111
