11111111111111111
100000C0000000001
100001111000C0001
1P0100000001100E1
11111111111111111
