111111111111
1100P0000011
1100C0000E11
1100C0000011
1100C0011111
1100C0000011
1100C0000011
1100C0000011
1100C0000011
1100C0000011
1100C0000011
1100C0000011
1000C0000011
1100C0000011
1100C0011111
1100C0000011
1100C0000011
1100C0000011
1100C0000011
1100C0000011
1100C0000011
1100C0000011
1000C0000011
1100C0011111
1100C0000011
1100C0000011
1100C0000011
1100C0000011
1100C0000011
1100C0000011
1100C0000011
1000C0000011
1100C0000011
1100C0011111
1100C0000011
1100C0000011
1100C0000011
1100C0000011
1100C0000011
1100C0000011
1100C0000011
1000C0000011
11E0E00P0011
111111111111
