111111111111
110000000011
110000000011
110000011111
100010000011
1100P0000011
111111111111
