11111111111111111
11000000000001111
11000000100000111
11000001111011111
10001000001000011
1100P000001000001
11111111111111111
