11111111111111111
11000000000001111
1100000000000E111
11000001111011111
10001000001000011
1100P00C001000001
11111111111111111
