111111111111111111111111111111111111
11111111111111111111110000000000C111
1100000000000111000000000000000000C1
1100000C10000011E0C00001100111111111
110000011110111111110100000000000111
1C001000011001110000C0011100C0011111
11P00000C110000000000000000011111111
111111111111111111111111111111111111
