111111111111111111111111111111111111
110000000000011111111111111111111111
110000001000001111111111111111111111
110000011110111111111111111111111111
100010000010000111111111111111111111
1100P0000010000011111111111111111111
111111111111111111111111111111111111
