11111111111111111111111111111
11111111000011000000000000001
11100000000000000000000C00001
111000000000C00000000011110E1
11100000000111000001111111111
1P000C000000C0001111111111111
11000100011111111111111111111
11111111111111111111111111111
