1111111111111
110000PCE0001
1111111111111

