11111111111111111111111
100000000000000000000011
1P0C00000000000000000E1
11111111111111111111111
